NO ./textures/mos_no.xpm
SO ./textures/mos_so.xpm
EA ./textures/mos_ea.xpm
WE ./textures/mos_we.xpm

C 0,201,255
F 227,213,154

   11 111111111
 1111110000N001
110000000000001
100000110000001
101010111100001
111111111111111
