NO ./textures/mos_no.xpm
SO ./textures/mos_so.xpm
EA ./textures/mos_ea.xpm
WE ./textures/mos_we.xpm

C 125,254,110
F 227,213,154

111111111111111111
110000000000000111
111111110001110011
1000000N0001100001
100000011100000111
111111111111111111
